==area:0==
@collision:B(41,124)
1,1,1,1,1,1,1,1,1,1,1,1,1,1,1,1,1,1,1,1,1,1,1,1,1,1,1,1,1,1,1,1,1,1,1,1,1,1,1,1,1,1,1,1,1,1,1,1,1,1,1,1,1,1,1,1,1,1,1
1,1,1,1,1,1,1,1,1,1,1,1,1,1,1,1,1,1,1,1,1,1,1,1,1,1,1,1,1,1,1,1,1,1,1,1,1,1,1,1,1,1,1,1,1,1,1,1,1,1,1,1,1,1,1,1,1,1,1
1,,,,,,,,1,,,,,,,,,,,,,,,,,,,,,,,,,,,,,,,,,,,,,,,,,1,,,,,,,,1,1
1,,,,,,,,1,,,,,,,,,,,,,,,,,,,,,,,,,,,,,,,,,,,,,,,,,1,,,,,,,,1,1
1,,,,,,,,1,,,,,,,,,,,,1,1,1,,1,1,1,,,,,,1,1,1,,1,1,1,,,,,,,,,,,1,,,,,,,,1,1
1,,,,,,,,1,,,,,,,,,,,,1,,1,,1,,1,,,,,,1,,1,,1,,1,,,,,,,,,,,1,,,,,,,,1,1
1,,,,,,,,1,,,,,1,1,1,,,,,1,1,1,,1,1,1,,,,,,1,1,1,,1,1,1,,,,,,,,,,,1,,,,,,,,1,1
1,,,,,,,,1,,,,,1,,1,,,,,,,,,,,,,,,,,,,,,,,,,,,,,,,,,,1,,,,,,,,1,1
1,,,,,,,,1,,,,2,1,1,1,3,,,,,,,,,,,,,,,,,,,,,,,,,,,,,,,,,1,,,,,,,,1,1
1,1
1,1
@event:B(73,128)
578,578,578
578,,578
@event:B(90,126)
574,5259
574,5259
574,5259
574,5259,,,565,5002
574,5259,241,241,241,241,241,241
574,5259,241,217,217,217,217,241
574,5259,241,217,208,208,217,241
@event:B(77,128)
579,579,579
579,,579
@event:B(65,128)
577,577,577
577,,577
@event:B(69,126)
133,219,133
133,240,133
133,133,133
133,5013,133
133,32,133
133,133,133
133,133,133
133,133,133
@event:B(61,128)
576,576,576
576,,576
@event:B(42,129)
,,565,5001
241,241,241,241,241,241
241,218,218,218,218,241
241,218,208,208,218,241
@event:B(49,126)
574,5316
574,5316
574,5316
574,5316
574,5316
574,5316
574,5316
@event:B(54,128)
565,5004
5005,5005,5005
573,573,573,5005
573,5005,573,5005
@event:B(81,126)
241,,,,,,,241
241,,,,,,,241
241,,,,,,,241
241,,,565,5003,,,241
241,243,243,243,243,243,243,241
241,243,220,220,220,220,243,241
241,243,220,208,208,220,243,241
@items:B(62,129)
37
@items:B(66,129)
38
@items:B(55,131)
42
@items:B(74,129)
39
@items:B(78,129)
40
@roombg:B(2,11)
83,83,83
@roomcolor:B(2,11)
24,24,24
@roomtype:B(2,11)
2,2,2
@tiles0:B(40,124)
0,0,0,0,0,0,0,0,0,0,0,0,0,0,0,0,0,0,0,0,0,0,0,0,0,0,0,0,0,0,0,0,0,0,0,0,0,0,0,0,0,0,0,0,0,0,0,0,0,0,0,0,0,0,0,0,0,0,0,0
0,0,0,0,0,0,0,0,0,0,0,0,0,0,0,0,0,0,0,0,0,0,0,0,0,0,0,0,0,0,0,0,0,0,0,0,0,0,0,0,0,0,0,0,0,0,0,0,0,0,0,0,0,0,0,0,0,0,0,0
0,0,0,0,0,0,0,0,0,0,0,0,0,0,0,0,0,0,0,0,0,0,0,0,0,0,0,0,0,0,0,0,0,0,0,0,0,0,0,0,0,0,0,0,0,0,0,0,0,0,0,0,0,0,0,0,0,0,0,0
0,0,0,0,0,0,0,0,0,0,0,0,0,0,0,0,0,0,0,0,0,0,0,0,0,0,0,0,0,0,0,0,0,0,0,0,0,0,0,0,0,0,0,0,0,0,0,0,0,0,0,0,0,0,0,0,0,0,0,0
0,0,0,0,0,0,0,0,0,0,0,0,0,0,0,0,0,0,0,0,0,0,0,0,0,0,0,0,0,0,0,0,0,0,0,0,0,0,0,0,0,0,0,0,0,0,0,0,0,0,0,0,0,0,0,0,0,0,0,0
0,0,0,0,0,0,0,0,0,0,0,0,0,0,0,0,0,0,0,0,0,0,0,0,0,0,0,0,0,0,0,0,0,0,0,0,0,0,0,0,0,0,0,0,0,0,0,0,0,0,0,0,0,0,0,0,0,0,0,0
0,0,0,0,0,0,0,0,0,0,0,0,0,0,0,0,0,0,0,0,0,0,0,0,0,0,0,0,0,0,0,0,0,0,0,0,0,0,0,0,0,0,0,0,0,0,0,0,0,0,0,0,0,0,0,0,0,0,0,0
0,0,0,0,0,0,0,0,0,0,0,0,0,0,0,0,0,0,0,0,0,0,0,0,0,0,0,0,0,0,0,0,0,0,0,0,0,0,0,0,0,0,0,0,0,0,0,0,0,0,0,0,0,0,0,0,0,0,0,0
0,0,0,0,0,0,0,0,0,0,0,0,0,0,0,0,0,0,0,0,0,0,0,0,0,0,0,0,0,0,0,0,0,0,0,0,0,0,0,0,0,0,0,0,0,0,0,0,0,0,0,0,0,0,0,0,0,0,0,0
0,0,0,0,0,0,0,0,0,0,0,0,0,0,0,0,0,0,0,0,0,0,0,0,0,0,0,0,0,0,0,0,0,0,0,0,0,0,0,0,0,0,0,0,0,0,0,0,0,0,0,0,0,0,0,0,0,0,0,0
0,0,0,0,0,0,0,0,0,0,0,0,0,0,0,0,0,0,0,0,0,0,0,0,0,0,0,0,0,0,0,0,0,0,0,0,0,0,0,0,0,0,0,0,0,0,0,0,0,0,0,0,0,0,0,0,0,0,0,0
@tiles1:B(40,124)
1563,1563,1563,1563,1563,1563,1563,1563,1563,1563,1563,1563,1563,1563,1563,1563,1563,1563,1563,1563,1563,1563,1563,1563,1563,1563,1563,1563,1563,1563,1563,1563,1563,1563,1563,1563,1563,1563,1563,1563,1563,1563,1563,1563,1563,1563,1563,1563,1563,1563,1563,1563,1563,1563,1563,1563,1563,1563,1563,1563
1563,6596,6531,6531,6531,6531,6531,6531,6531,6531,6531,6531,6531,6531,6531,6531,6531,6531,6531,6531,6531,6531,6531,6531,6531,6531,6531,6531,6531,6531,6531,6531,6531,6531,6531,6531,6531,6531,6531,6531,6531,6531,6531,6531,6531,6531,6531,6531,6531,6531,6531,6531,6531,6531,6531,6531,6531,6531,-6596,1563
1563,1564,,,,,,,,513,,,,,,,,,,,,,,,,,,,,,,,,,,,,,,,,,,,,,,,,,513,,,,,,,,-1564,1563
1563,1564,,,,,,,,513,,,,,,,,,,,,,,,,,,,,,,,,,,,,,,,,,,,,,,,,,513,,,,,,,,-1564,1563
1563,1564,,,,,,,,513,,,,,,,,,,,,513,513,513,,513,513,513,,,,,,513,513,513,,513,513,513,,,,,,,,,,,513,,,,,,,,-1564,1563
1563,1564,,,,,,,,513,,,,,,,,,,,,513,,513,,513,,513,,,,,,513,,513,,513,,513,,,,,,,,,,,513,,,,,,,,-1564,1563
1563,1564,,,,,,,,513,,,,,262,262,262,,,,,1782,1783,-1782,,1782,1783,-1782,,,,,,1782,1783,-1782,,1782,1783,-1782,,,,,,,,,,,513,,,,,,,,-1564,1563
1563,1564,,,,,,,,513,,,,,262,,262,,,,,,,,,,,,,,,,,,,,,,,,,,,,,,,,,,513,,,,,,,,-1564,1563
1563,1564,,,,,,,,513,,,,293,294,295,-294,-293,,,,,,,,,,,,,,,,,,,,,,,,,,,,,,,,,513,,,,,,,,-1564,1563
1563,1596,1531,1531,1531,1531,1531,1531,1531,1531,1531,1531,1531,1531,1531,1531,1531,1531,1531,1531,1531,1531,1531,1531,1531,1531,1531,1531,1531,1531,1531,1531,1531,1531,1531,1531,1531,1531,1531,1531,1531,1531,1531,1531,1531,1531,1531,1531,1531,1531,1531,1531,1531,1531,1531,1531,1531,1531,-1596,1563
1563,1563,1563,1563,1563,1563,1563,1563,1563,1563,1563,1563,1563,1563,1563,1563,1563,1563,1563,1563,1563,1563,1563,1563,1563,1563,1563,1563,1563,1563,1563,1563,1563,1563,1563,1563,1563,1563,1563,1563,1563,1563,1563,1563,1563,1563,1563,1563,1563,1563,1563,1563,1563,1563,1563,1563,1563,1563,1563,1563
@tiles2:B(44,130)
1577,1578,1579
1609,1610,1611
1641,1642,1643
@tiles2:B(84,130)
1577,1578,1579
1609,1610,1611
1641,1642,1643
@tiles2:B(94,130)
1577,1578,1579
1609,1610,1611
1641,1642,1643