==area:0==
@collision:B(60,124)
1,1,1,1,1,1,1,1,1,1,1,1,1,1,1,1,1,1,1,1,1,1
1,1,1,1,1,1,1,1,1,1,1,1,1,1,1,1,1,1,1,1,,1
1,1,,,,,,1,,,,,,,,,,,1,1,,1
1,1,,,,,,1,,,,,,,,,,,1,1,1,1
1,1,,,,,,1,,,,,,,,,,,1,1
1,1,,,,,,1,,,,,,,,,,,1,1
1,1,,,,,,1,,,,,,,,,,,1,1
1,1,,,,,,1,,,,,,,,,,,1,1
1,1,,,,,,1,,,,,,,,,,,1,1
@event:B(62,126)
,,,,,574,5316,133,219,133,241
,,,,,574,5316,133,240,133,241
,,,,,574,5316,133,133,133,241
,,,,,574,5316,133,5013,133,241
241,241,241,241,241,574,5316,133,32,133,241,243,243,243,243,243
241,218,218,218,241,574,5316,133,133,133,241,243,220,220,220,243
241,218,208,218,241,574,5316,133,133,133,241,243,220,208,220,243
,,,,,,,133,133,133
@roombg:B(3,11)
83
@roomcolor:B(3,11)
24
@roomtype:B(3,11)
1
@tiles0:B(60,124)
0,0,0,0,0,0,0,0,0,0,0,0,0,0,0,0,0,0,0,0
0,0,0,0,0,0,0,0,0,0,0,0,0,0,0,0,0,0,0,0
0,0,0,0,0,0,0,0,0,0,0,0,0,0,0,0,0,0,0,0
0,0,0,0,0,0,0,0,0,0,0,0,0,0,0,0,0,0,0,0
0,0,0,0,0,0,0,0,0,0,0,0,0,0,0,0,0,0,0,0
0,0,0,0,0,0,0,0,0,0,0,0,0,0,0,0,0,0,0,0
0,0,0,0,0,0,0,0,0,0,0,0,0,0,0,0,0,0,0,0
0,0,0,0,0,0,0,0,0,0,0,0,0,0,0,0,0,0,0,0
0,0,0,0,0,0,0,0,0,0,0,0,0,0,0,0,0,0,0,0
0,0,0,0,0,0,0,0,0,0,0,0,0,0,0,0,0,0,0,0
0,0,0,0,0,0,0,0,0,0,0,0,0,0,0,0,0,0,0,0
@tiles1:B(60,124)
1563,1563,1563,1563,1563,1563,1563,1563,1563,1563,1563,1563,1563,1563,1563,1563,1563,1563,1563,1563
1563,6596,6531,6531,6531,6531,6531,6531,6531,6531,6531,6531,6531,6531,6531,6531,6531,6531,-6596,1563
1563,1564,,,,,,513,,,,,,,,,,,-1564,1563
1563,1564,,,,,,513,,,,,,,,,,,-1564,1563
1563,1564,,,,,,513,,,,,,,,,,,-1564,1563
1563,1564,,,,,,513,,,,,,,,,,,-1564,1563
1563,1564,,,,,,513,,,,,,,,,,,-1564,1563
1563,1564,,,,,,513,,,,,,,,,,,-1564,1563
1563,1564,,,,,,513,,,,,,,,,,,-1564,1563
1563,1596,1531,1531,1531,1531,1531,1531,1531,1531,1531,1531,1531,1531,1531,1531,1531,1531,-1596,1563
1563,1563,1563,1563,1563,1563,1563,1563,1563,1563,1563,1563,1563,1563,1563,1563,1563,1563,1563,1563
@tiles2:B(63,130)
1577,1578,1579,,,,,,,,,,1577,1578,1579
1609,1610,1611,,,,,,,,,,1609,1610,1611
1641,1642,1643,,,,,,,,,,1641,1642,1643