==area:5==
@collision:B(223,161)
1,1,1,1,1,1,1,1,1,1,1,1,1
1,1,1,1,1,1,1,1,1,1,1,1,1
1,1,,,,,,,,,,1,1
1,1,,,,,,,,,,1,1
1,1,,,,,,,,,,1,1
1,1,1,1,1,1,1,1,1,1,1,1,1
1,1,1,1,1,1,1,1,1,1,1,1,1
@event:L
225,142:81
225,165:80
226,165:80
227,163:357
227,164:357
227,165:357
228,163:524
228,164:524
228,165:524
229,163:526
229,164:526
229,165:526
230,163:357
230,164:357
230,165:357
231,163:524
231,164:524
231,165:524
232,163:357
232,164:357
232,165:357
@roombg:B(11,14)
12
@roomcolor:B(11,14)
12
@roomtype:B(11,14)
1
@tiles0:B(225,163)
379,379,379,379,379,379,379,379,379
379,379,379,379,379,379,379,379,379
379,379,379,379,379,379,379,379,379
@tiles1:B(220,158)
1488,1488,1488,1488,1488,1488,1488,1488,1488,1488,1488,1488,1488,1488,1488,1488,1488,1488,1488,1488
855,1488,1488,1488,1488,1488,1488,1488,1488,1488,1488,1488,1488,1488,855,1488,1488,1488,1488,1488
1488,855,855,855,855,855,855,855,855,855,855,855,855,855,1488,1488,1488,1488,1488,1488
1488,1488,1488,1488,855,855,855,855,855,855,855,855,855,855,855,855,1488,1488,1488,1488
1488,1488,1488,1488,-603,-570,570,570,570,570,570,570,570,570,603,1488,1488,1488,1488,1488
855,1488,1488,1488,-602,1673,1674,,,,,,,,602,1488,1488,1488,1488,1488
855,1488,1488,1488,-602,1705,1706,,,,,,,,602,855,1488,1488,1488,1488
1488,1488,1488,1488,-602,1737,1738,,,,,,,,602,1488,1488,1488,1488,1488
1488,1488,1488,1488,-5603,-5570,5570,5570,5570,5570,5570,5570,5570,5570,5603,1488,1488,1488,1488,1488
1488,1488,1488,1488,1488,1488,1488,1488,1488,1488,1488,1488,1488,1488,1488,1488,1488,1488,1488,1488
855,855,855,855,855,855,855,855,855,855,855,855,855,855,855,855,855,855,855,855
@tiles3:B(225,141)
-1773
1773
@tiles4:L
225,140:1521
225,141:1716
225,142:6716
231,163:1780
231,164:1780
231,165:1780
232,163:1780
232,164:1780
232,165:1780
233,163:1780
233,164:1780
233,165:1780