==area:2==
@collision:B(44,164)
1,1,1,1,1,1,1,1
1,1,1,1,1,1,1,1
@event:B(44,164)
7,7,7,7,7,7,8,8
7,7,7,7,7,7,8,8
@tiles1:B(44,164)
541,541,541,541,541,541,1743,1743
541,541,541,541,541,541,1743,1743