==area:2==
@collision:B(44,164)
1,1,1,1,1,1,1,1
1,1,1,1,1,1,1,1
@event:B(44,164)
8,8,8,8,8,8,8,8
8,8,8,8,8,8,8,8
@tiles1:B(44,164)
1743,1743,1743,1743,1743,1743,1743,1743
1743,1743,1743,1743,1743,1743,1743,1743