==area:2==
@collision:B(44,164)
1,1,1,1,1,1,1,1
1,1,1,1,1,1,1,1
@event:B(44,164)
1,1,1,1,1,1,8,8
1,1,1,1,1,1,8,8
@tiles1:B(44,164)
32,32,32,32,32,32,1743,1743
32,32,32,32,32,32,1743,1743